R 1280 1000

NO ./textures/redbrick.xpm
SO ./textures/eagle.xpm
WE ./textures/greystone.xpm
EA ./textures/bluestone.xpm

S ./textures/ITEM.xpm

F 149,75,0
C 17,40,170

1111111111111111111111111
1000000000110000000000001
10110000011120000W0000001
1001000000000000000000001
1111111110110000011100001
1000000000110000011101111
1000000000000000110101001
1100000111010101111101111
1111111111111111111111111
