R 640 640

NO textures/ocean.xpm
SO textures/blrose.xpm
WE textures/blflower.xpm
EA textures/bluewave.xpm

S textures/sebastian.xpm

F 36,21,113
C 130,238,253

1111111111111111111111111
1000000000110000000000001
10110030011120000W0000001
1001000000000030000000001
1111111110110000011100001
1000000000110030011101111
1000000000000000110101001
1100000111010101111101111
1111111111111111111111111
